########################################
#00000#00000000000000000000000000000000#
#00*00D00000000000000000000000000000000#
#00000#00000000000000000000000000000000#
#00000#00000000000000000000000000000000#
#######00000000000000000000000000000000#
#000000000000000000000000000000000######
#000000000000000000000000000000000#0000#
#00000000000000000000000000000000000000#
#000000000000000000000000000000000#00*0#
#000000000000000000000000000000000#0000#
#000000000000000000000000000000000######
#00000000000000###D###00000000000000000#
#00000000000000#00000#00000000000000000#
#00000000000000#00000#00000000000000000#
#00000000000000#00X00#00000000000000000#
#00000000000000#00000#00000000000000000#
#00000000000000#######00000000000000000#
#00000000000000000000000000000000000000#
#00000000000000000000000000000000000000#
#00000000000000000000000000000000000000#
#00000000000000000000000000000000000000#
#00000000000000000000000000000000000000#
#00000000000000000000000000000000000000#
########################################