#########################
#00000#00000000000000000#
#00000#00000000000000000#
#0*000#00000000000000000#
#00000000000000000000000#
#######00000000000000000#
#00000000000000000000000#
#00000000000000000000000#
#00000000000000000000000#
#00000000000000000000000#
#00000000000000000##D####
#00000000000000000#00000#
#00000000000000000#00000#
#00000000000000000#0000X#
#########################